0 0 0 0 0 0 0 0 0 0 0 0 0 0 0 0 0 0 0 0 0 0 0 0 0 0 0 0 0 0 0 0 0 0 0 0 0 0 0 0 0 0 0 0 0 0 0 0 0 0
0 0 0 0 0 0 0 0 0 0 0 0 0 0 0 0 0 0 0 0 0 0 0 0 0 0 0 0 0 0 0 0 0 0 0 0 0 0 0 0 0 0 0 0 0 0 0 0 0 0
0 0 0 0 3 3 3 3 3 3 3 3 3 3 3 3 3 0 0 0 0 0 0 0 0 0 0 0 0 0 0 0 0 0 0 0 0 0 0 0 0 0 0 0 0 0 0 0 0 0
0 0 0 0 3 2 2 2 2 2 2 2 2 2 5 2 3 0 0 0 0 0 0 0 0 0 0 0 0 0 0 0 0 0 0 0 0 0 0 0 0 0 0 0 0 0 0 0 0 0
0 0 0 0 3 2 5 5 5 5 5 5 5 5 5 2 3 0 0 0 0 0 0 0 0 0 0 0 0 0 0 0 0 0 0 0 0 0 0 0 0 0 0 0 0 0 0 0 0 0
0 0 0 0 3 2 5 2 2 2 2 2 2 2 2 2 3 0 0 0 0 0 0 0 0 0 0 0 0 0 0 0 0 0 0 0 0 0 0 0 0 0 0 0 0 0 0 0 0 0
0 0 0 0 3 2 5 2 5 5 5 5 5 5 5 2 3 0 0 0 0 0 0 0 0 0 0 0 0 0 0 0 0 0 0 0 0 0 0 0 0 0 0 0 0 0 0 0 0 0
0 0 0 0 3 2 5 2 5 2 2 2 2 2 5 2 3 0 0 0 0 0 0 4 0 0 0 0 0 0 0 0 0 0 0 0 0 0 0 0 0 0 0 0 0 0 0 0 0 0
0 0 0 0 3 2 5 5 5 2 5 5 5 5 5 2 3 0 0 0 0 0 0 4 0 0 0 0 0 0 0 0 0 0 0 0 0 0 0 0 0 0 0 0 0 0 0 0 0 0
0 0 0 0 3 2 2 2 2 2 5 2 2 2 2 2 3 0 0 0 0 0 0 4 0 0 0 0 0 0 0 0 0 0 0 0 0 0 0 0 0 0 0 0 0 0 0 0 0 0
0 0 0 0 3 3 3 3 3 3 4 3 3 3 3 3 3 0 0 0 0 0 0 4 0 6 6 6 6 6 6 6 6 6 6 6 6 6 6 6 0 0 0 0 0 0 0 0 0 0
0 0 0 0 0 0 0 0 0 0 4 0 0 0 0 0 0 0 0 0 0 0 0 4 0 0 6 6 6 6 6 6 6 6 6 6 6 6 6 6 7 0 0 0 0 0 0 0 0 0
0 0 0 0 0 0 0 0 0 0 4 0 0 0 0 6 6 6 6 6 6 6 6 4 0 0 0 0 7 6 6 6 6 7 6 6 6 7 6 6 7 6 6 6 6 7 6 0 0 0
0 0 0 0 0 0 0 0 0 0 4 4 4 4 4 4 4 4 4 4 4 4 4 4 0 0 0 0 6 6 6 7 6 6 6 6 7 6 6 6 7 6 6 0 0 0 0 0 0 0
0 0 0 0 0 0 0 0 7 7 7 6 6 6 6 7 0 0 0 4 6 6 6 6 6 6 6 6 6 6 7 7 7 7 7 7 7 7 6 6 6 6 7 6 6 6 7 6 6 0
0 0 0 0 0 0 0 0 0 6 6 6 6 6 6 6 6 6 6 4 0 0 0 0 6 6 6 6 6 7 7 7 7 6 7 6 6 7 0 0 0 0 0 0 0 0 0 0 0 0
0 0 0 0 0 0 6 6 6 6 6 6 7 7 7 6 7 7 6 4 6 6 6 6 6 6 6 6 6 6 6 6 6 7 6 7 7 0 6 6 6 6 6 6 0 6 6 6 6 6
0 0 0 0 0 0 6 2 2 2 2 6 7 6 6 7 7 6 7 4 0 6 7 6 7 7 7 7 7 2 6 6 6 6 6 6 7 6 6 6 6 7 6 6 6 0 0 0 6 6
0 0 0 0 0 0 6 2 2 2 2 6 6 6 6 6 6 7 6 4 6 6 6 0 0 0 0 0 0 0 0 0 0 0 0 0 0 0 0 0 0 0 0 7 6 6 6 0 7 6
0 0 0 0 0 0 6 2 2 2 2 5 4 4 4 4 4 4 4 4 4 4 4 4 6 6 6 6 6 6 6 6 6 6 6 7 6 7 7 6 6 0 0 0 0 0 0 0 6 6
0 0 0 0 0 0 6 2 2 2 2 6 0 0 0 0 0 0 0 0 0 0 0 4 7 7 7 7 6 6 6 6 6 6 7 7 7 7 7 7 7 7 7 7 6 0 0 0 6 7
0 0 0 0 0 0 6 2 2 2 2 6 0 0 0 0 0 6 6 0 0 7 0 4 0 6 6 6 6 0 0 0 7 6 6 7 7 6 6 6 6 6 6 6 6 6 0 0 6 6
0 0 0 0 0 0 6 2 2 2 2 6 0 0 7 6 6 0 0 0 6 0 0 4 0 0 0 7 7 7 7 0 7 7 7 7 7 7 7 7 7 0 0 0 0 0 0 6 6 6
0 0 0 0 0 0 6 6 6 6 6 6 7 7 6 7 6 0 0 0 0 0 0 4 6 6 6 6 6 6 6 0 0 0 0 7 7 7 7 7 7 0 0 0 6 6 6 6 6 6
0 0 0 0 0 0 0 0 0 6 7 7 7 6 7 6 6 6 6 7 6 6 6 4 0 6 6 6 6 6 6 6 6 6 0 6 6 6 6 6 6 0 6 6 7 6 6 6 6 6
0 0 0 0 6 6 6 6 6 6 6 6 6 6 6 6 6 6 6 6 6 6 6 4 6 6 6 6 6 6 6 7 7 6 0 6 7 7 6 6 3 5 3 3 3 3 3 3 7 6
0 0 0 0 0 0 6 6 6 6 6 6 6 6 6 6 6 6 6 6 6 6 6 4 6 6 6 6 6 6 6 7 6 6 0 0 0 0 6 6 3 5 5 5 5 5 5 3 7 6
0 0 0 0 0 0 6 6 6 6 6 6 0 0 0 0 0 0 0 0 0 0 0 4 7 7 6 6 6 6 7 6 6 6 7 6 6 0 0 6 3 3 3 3 3 3 3 3 6 6
0 0 0 0 0 6 6 6 6 6 6 6 0 6 6 6 6 6 6 6 6 6 6 4 6 6 6 6 6 6 7 6 6 6 6 6 6 6 0 6 6 6 6 6 6 6 6 3 6 0
0 0 0 0 0 7 6 6 6 6 6 6 0 6 6 6 6 6 6 6 6 6 0 4 7 6 6 6 7 6 6 6 6 6 6 6 6 6 0 0 0 0 0 6 6 6 6 6 6 6
0 0 0 0 0 7 6 6 6 6 6 6 0 6 6 6 6 6 6 6 6 6 6 4 4 4 4 4 4 4 4 4 4 4 4 6 6 6 6 6 6 6 0 6 6 6 6 6 6 6
0 0 0 0 0 0 0 0 0 0 0 0 0 6 6 6 6 0 7 6 0 0 0 0 0 0 0 0 0 6 6 6 6 6 4 0 0 0 6 6 6 6 0 6 6 6 6 6 6 6
0 0 0 0 0 0 0 0 0 0 0 0 0 6 6 6 6 7 7 6 6 6 6 6 6 6 6 6 6 6 6 6 3 3 4 3 3 0 0 0 0 0 0 6 6 6 6 6 6 0
0 0 0 0 0 0 0 0 0 0 0 0 0 0 0 0 0 6 6 6 6 6 6 6 6 6 6 6 6 6 6 6 3 5 5 5 3 6 6 6 6 6 6 6 6 6 6 6 6 6
0 0 0 0 0 0 2 2 2 2 2 2 2 0 0 0 0 0 6 7 6 7 7 7 7 7 7 7 6 6 6 6 3 5 5 5 3 6 6 6 6 6 6 6 6 6 6 6 6 6
0 0 0 0 0 0 2 2 2 2 2 2 2 0 0 0 0 0 0 6 6 6 6 7 7 7 7 6 6 7 6 6 3 5 5 5 3 6 6 6 6 6 6 6 6 6 6 6 6 6
0 0 0 0 0 0 0 0 0 0 0 0 0 0 0 0 0 6 6 6 6 6 6 6 6 6 6 6 6 6 6 6 3 3 3 3 3 6 6 6 6 6 6 6 6 6 6 6 6 6
0 0 0 0 0 0 0 0 0 0 0 0 6 6 6 6 7 7 7 7 6 6 7 6 6 6 6 6 6 7 7 7 7 6 6 7 6 6 6 6 6 6 7 7 7 7 6 6 7 6
0 0 0 0 0 0 0 0 0 0 6 6 6 6 7 7 7 7 6 6 7 6 6 6 6 6 6 7 7 7 7 6 6 7 6 6 6 6 6 6 7 7 7 7 6 6 7 6 6 6
0 0 0 0 0 0 0 0 0 0 0 0 0 0 0 0 0 0 0 0 0 0 0 0 0 0 0 0 0 0 0 0 0 0 0 0 0 0 0 0 0 0 0 0 0 0 0 0 0 0
0 0 0 0 0 0 0 0 0 0 0 0 0 0 0 0 0 0 0 0 0 0 0 0 0 0 0 0 0 0 0 0 0 0 0 0 0 0 0 0 0 0 0 0 0 0 0 0 0 0
0 0 0 0 0 0 0 0 0 0 0 0 0 0 0 0 0 0 0 0 0 0 0 0 0 0 0 0 0 0 0 0 0 0 0 0 0 0 0 0 0 0 0 0 0 0 0 0 0 0
0 0 0 0 0 0 0 0 0 0 0 0 0 0 0 0 0 0 0 0 0 0 0 0 0 0 0 0 0 0 0 0 0 0 0 0 0 0 0 0 0 0 0 0 0 0 0 0 0 0
0 0 0 0 0 0 0 0 0 0 0 0 0 0 0 0 0 0 0 0 0 0 0 0 0 0 0 0 0 0 0 0 0 0 0 0 0 0 0 0 0 0 0 0 0 0 0 0 0 0
0 0 0 0 0 0 0 0 0 0 0 0 0 0 0 0 0 0 0 0 0 0 0 0 0 0 0 0 0 0 0 0 0 0 0 0 0 0 0 0 0 0 0 0 0 0 0 0 0 0
0 0 0 0 0 0 0 0 0 0 0 0 0 0 0 0 0 0 0 0 0 0 0 0 0 0 0 0 0 0 0 0 0 0 0 0 0 0 0 0 0 0 0 0 0 0 0 0 0 0
0 0 0 0 0 0 0 0 0 0 0 0 0 0 0 0 0 0 0 0 0 0 0 0 0 0 0 0 0 0 0 0 0 0 0 0 0 0 0 0 0 0 0 0 0 0 0 0 0 0
0 0 0 0 0 0 0 0 0 0 0 0 0 0 0 0 0 0 0 0 0 0 0 0 0 0 0 0 0 0 0 0 0 0 0 0 0 0 0 0 0 0 0 0 0 0 0 0 0 0
0 0 0 0 0 0 0 0 0 0 0 0 0 0 0 0 0 0 0 0 0 0 0 0 0 0 0 0 0 0 0 0 0 0 0 0 0 0 0 0 0 0 0 0 0 0 0 0 0 0
0 0 0 0 0 0 0 0 0 0 0 0 0 0 0 0 0 0 0 0 0 0 0 0 0 0 0 0 0 0 0 0 0 0 0 0 0 0 0 0 0 0 0 0 0 0 0 0 0 0